4 4 4 4 4 4 4 4 4 4 4 4 4 4 4 4 4
4 1 1 1 1 1 1 1 1 1 1 1 1 1 1 1 4
4 1 3 2 2 3 3 3 3 3 3 3 3 3 3 1 4
4 1 0 1 2 1 2 1 0 1 0 1 0 1 0 1 4
4 1 0 3 2 3 2 3 0 3 2 3 0 3 0 1 4
4 1 0 1 0 1 3 1 2 1 3 1 2 1 2 1 4
4 1 0 3 0 3 0 3 3 3 2 3 2 3 2 1 4
4 1 0 1 0 1 0 1 2 1 2 1 3 1 0 1 4
4 1 0 3 0 3 0 3 3 3 3 3 0 3 0 1 4
4 1 1 1 1 1 1 1 1 1 1 1 1 1 1 1 4
4 4 4 4 4 4 4 4 4 4 4 4 4 4 4 4 4